S...X...
....X...
....X...
....X...
....X...
........
..22222.
.......G
---
D,5,3,4,5,6
